############################################################
############################################################
##XXXXXXXXXXXXXXXXXXXXXXXXXXXXXXXXXXXXXXXXXXXXXXXXXXXXXXXX##
##X                                                      X##
##X J                                              F     X##
##X                                                      X##
##X                                                      X##
##X                                                      X##
##X                                                      X##
##X                                                      X##
##X                                                      X##
##X                                                      X##
##X                                                      X##
##X                                                      X##
##X                                                      X##
##X                                                       P#
##X                                                      X##
##X                                                      X##
##X                                                      X##
##X                                                      X##
##X                                                      X##
##X                                                      X##
##X                                                      X##
##X                                                      X##
##X                                                      X##
##X                                                      X##
##X                                                      X##
##XXXXXXXXXXXXXXXXXXXXXXXXXXXXXXXXXXXXXXXXXXXXXXXXXXXXXXXX##
############################################################
############################################################

