############################################################
#                         #                                #
#                         #                                #
#                         #                                #
#          ################                      ###########         
#                                                          #
#                                                          #
#                                                          #
#            ##############                                #
#            #            #                                #
#            #            #                                #
#            #            ##########                       #
#            #                                             #
##############                                             #
#                                                          #
#                                ###########################                         
#                                #                         #
#                                #                         #
#                                #                         #
#                    #           #                         #
#                    #                      ################
#                    #                                     #
#                    #                                     #
#                    #                                     #
# ####################                                     #
#                                                          #
#                                                          #
#                                                          #
############################################################
############################################################
